6,14
##############
#    ###     #
# #     S# ###
# ########   #
#       E##  #
##############
