14,14
##############
#   ####     #
# #     S#####
# ########   #
#    #E    # #
# ########## #
# #   #      #
# ### # #### #
#  ## #    ###
## ## #### ###
## ##        #
##    ###### #
## ####      #
##############
